S00WWWWW0W00WWW
0W00000W0WW0W00
00WW0W000W0000W
W000WWWW000WWWW
000W00000WWW00W
WW0WWWW0W0000WW
000WWW0000WWWWW
0W000WW0W0W000W
0WW0W000W000WWW
WWW00WWWW0WWWWW
WWW0WW0W00WW00W
W000000W0WW00WW
00WW00W00000WWW
WWWWW0WW0WW0WWW
W00000WW00W000M