WWWWWWWWWWWWWWWWW
WS00WWWWW0W00WWWW
W0W00000W0WW0W00W
W00WW0W000W0000WW
WW000WWWW000WWWWW
W000W00000WWW00WW
WWW0WWWW0W0000WWW
W000WWW0000WWWWWW
W0W000WW0W0W000WW
W0WW0W000W000WWWW
WWWW00WWWW0WWWWWW
WWWW0WW0W00WW00WW
WW000000W0WW00WWW
W00WW00W00000WWWW
WWWWWW0WW0WW0WWWW
WW00000WW00W000MW
WWWWWWWWWWWWWWWWW